R  300000 3000000
NO ./textures/brick.xpm
SO ./textures/blue.xpm
WE ./textures/wood.xpm
EA ./textures/grey.xpm

S ./textures/item.xpm
F 224,172,105
C 205,249,255

        111111  1111  1111  1111  1111  1111
        100001  1001  1001  1001  1001  1001
        100001111001111001111001111001111001
        100000000000000000000000000000000001
        1111111100000S0000000000000000000001
        100000000000000000010000000111111111
        111110000000000000010000000000000001
        100000200000000000010000000000000001
        100000000000000000000000000000000001
        111111111111111111111111111111111111
