R  500 500
NO ../textures/brick.xpm
SO ../textures/blue.xpm
WE ../textures/wood.xpm
EA ../textures/grey.xpm

S ../textures/chest.xpm
F 224,172,105
C 205,249,255

11111111111111  1111  1111  1111  1111  1111
10000000000001  1001  1001  1001  1001  1001
10000020000001111001111001111001111001111001
10000000000000000000000000000000000000000001
11111111100000S00000000000000000000000000001
        100000000000000000000000000111111111
        111110000000000000000000000000000001
        100000200000000000000000000000000001
        100000000000000000000000000000000001
        111111111111111111111111111111111111
