R 2000 2000
NO ./textures/wall.xpm
SO ./textures/wall.xpm
WE ./textures/wall.xpm
EA ./textures/grass.xpm

S ./textures/item.xpm
F 224,172,105
C 205,249,255

11111111111111111111111111111111111111111111
10000000000010000000000000000100000000000001
11100002000010000020000020000100000200000111
  1000000000100000000000000001000000000001
11100000000000000000000000000000000000000111
10000002000000000000S00000000000000000000001
11100200000000000000000000000000000000000111
  1020000000011111111000000000000000000001
11100000000000200000100020000000000200000111
10000000000000000000100000000000000000000001
11111111111111111111111111111111111111111111
