R 800 500
NO ./textures/north.xpm
SO ./textures/south.xpm
WE ./textures/west.xpm
EA ./textures/east.xpm

S ./textures/item.xpm
F 224,172,105
C 205,249,255

11111111111111
10200010000201
10000010002001
10200010020001
100101E1011111
10010010200001
11111111111111
