R  1000 1000
NO ../textures/brick.xpm
SO ../textures/blue.xpm
WE ../textures/wood.xpm
EA ../textures/grey.xpm

S ../textures/chest.xpm
F 224,172,105
C 205,249,255

        111111  1111  1111  1111  1111  1111
        100001  1001  1001  1001  1001  1001
        100001111001111001111001111000111001
        100000000000000000000000000000000001
        100000S00000000000000000000000000001
        100000000000000000000000000000000001
        100000000000000000000000000000000001
        100000200000000000000000000000000001
        100000000000000000000000000000000001
        111111111111111111111111111111111111
