R  3000 3000
NO ../textures/bigbang/tshirt1.xpm
SO ../textures/bigbang/tshirt2.xpm
WE ../textures/bigbang/tshirt3.xpm
EA ../textures/bigbang/tshirt4.xpm

S ../textures/chest.xpm
F 224,172,105
C 205,249,255

1 1 1 1 1 1 1 1 1 1
1 0 0 0 0 0 0 0 0 1
1 0 0 E 0 0 0 0 0 1
1 0 0 0 0 0 0 0 0 1
1 0 0 0 1 1 1 1 1 1
1 2 0 0 0 0 0 0 0 1
1 1 1 0 0 0 0 0 0 1
1 0 0 0 0 0 0 2 0 1
1 1 1 1 1 0 1 1 1 1
1 1 1 1 1 0 0 0 0 1
1 1 1 1 1 2 0 0 0 1
1 1 1 1 1 0 0 0 0 1
1 1 1 1 1 1 1 1 1 1
