R  800 500
NO ../textures/bigbang/tshirt1.xpm
SO ../textures/bigbang/tshirt2.xpm
WE ../textures/bigbang/tshirt3.xpm
EA ../textures/bigbang/tshirt4.xpm

S ../textures/bigbang/tshirt4.xpm
F 224,172,105
C 205,249,255

11111111111111
10200010000201
10000010002001
10200000020001
100100S0011111
10010000200001
11111111111111
