R  500000000 50000000
NO ./textures/bigbang/tshirt1.xpm
SO ./textures/bigbang/tshirt2.xpm
WE ./textures/bigbang/tshirt3.xpm
EA ./textures/bigbang/tshirt4.xpm

S ./textures/item.xpm
F 255,172,105
C 205,249,255

11111111111111
10000010000201
10000000002001
10000000020001
10000000S01111
10010010000001
11111111111111
