R 800 500
NO ./textures/north.xpm
SO ./textures/south.xpm
WE ./textures/west.xpm
EA ./textures/east.xpm

S ./textures/item.xpm
F 224,172,105
C 205,249,255

	 11111111111111
     11111111111111
     10200010000201
     10000010002001
1111110200000020001
100100S001111111111
10010000200001
11111111111111
