R  500 500
NO ../textures/brick.xpm
SO ../textures/blue.xpm
WE ../textures/wood.xpm
EA ../textures/grey.xpm

S ../textures/chest.xpm
F 224,172,105
C 205,249,255

1111111111111111111111
1000000000000000000001
1000000000000000011111
10000000000000000111
1000000000000000111
100W0000000001111
10000000000011
100000000111111111111
100000000001111000111
100000000001111000111
100000000001111000111
111111111111111111111
