R 80000 600000
NO ./textures/north.xpm
SO ./textures/south.xpm
WE ./textures/west.xpm
EA ./textures/east.xpm

S ./textures/item.xpm
F 100,100,100
C 205,249,255

11111111111111
10200000000211
10000010002001
10200000020001
100100S0011111
10010000200001
11111111111111
